{
    "colors": [
        "#574a3c",
        "#cd0606",
        "#f8ca87",
        "#9e9e9e",
        "#cfcac7",
        "#7d0404",
        "#d17c5d",
        "#79736a"
    ]
}