{
    "colors": [
        "#62442d",
        "#e6ddd6",
        "#a38373",
        "#b20606",
        "#2a211e",
        "#7e5f47",
        "#876f60",
        "#d6b4a0",
        "#c4b42a",
        "#b1958c"
    ]
}